--------------------
--------------------
---------WWWWW------
--------------------
--------------------
--G------R----------
-WNNNNWWWWWW--WW-NW-
-W------F---------W-
-W---------AAA--W-W-
-WS-W---W--R------W-
-NNN-----WWWOWW---W-
-----OOO--WW-WW---W-
--P---------------W-
-WWWWWWWWWWWWWWWWWW-
--------------------
--------------------