--------------------
--------------------
---------WWWWW------
--------------------
--------------------
--G------M----------
-WNNNNWWWWWW--WW-NW-
-W------B---------W-
-W---------AAA--W-W-
-WS-W---W--M------W-
-NNN-----WWWOWW-UUW-
-----OOO--WW-WW-UUW-
--P-------RRRRR---W-
-WWWWWWWWWWWWWWWWWW-
--------------------