--------------------
--------------------
--------------------
--------------------
--------------------
--G-----------------
-WNNNNWWWWWW--WWNNW-
-W----------------W-
-W---------AAA----W-
-WS-W---W---------W-
-NNN-----WWWOWW-UUW-
-----OOO--WW-WW-UUW-
--P-------RRRRR---W-
-WWWWWWWWWWWWWWWWWW-
--------------------