--------------------
--------------------
--------------------
--------------------
--------------------
--G-----------------
-WNNNNWWWWWW--WWNNW-
-W----------------W-
-W---------AAA----W-
-WS-W---W---------W-
-NNN-----WWWOWW---W-
-----OOO--WW-WW---W-
--P---------------W-
-WWWWWWWWWWWWWWWWWW-
--------------------
R-------------------