--------------------
--------------------
--------WWW---------
--------------------
---OO------------A--
-------------SS-----
-------------WW-----
--------------------
--------------------
--------------------
----------SS--------
----------WW--------
--P-----------------
-WWWW-----------OO--
--WW----------------
--------------------