--------------------
-----------------G--
-------------WWWNNNN
------------WWWNN---
-------OO---------A-
--------------------
--------------------
-------WW-----------
--------------------
-----------------OO-
--------------------
------------OOO-----
--P-----------------
-WWWWW--------------
--WWW---------------
--------------------