------------WOOONNNN
----------------NNNN
----------------NNNN
---------------WNNNN
----------------NNNN
----------------NNNN
----------------NNNN
----------------NNNN
----------------NNNN
----WWWWWWWWWWWWWWWW
----WWWWWWWWWWWWWWWW
---OWWWWWWWWWWWWWWWW
-----WWWWWWWWWWWWWWW
---P-WWWWWWWWWWWWWWW
--OOOWWWWWWWWWWWWWWW
--------------------