--------------------
---------S-G--------
---------NNNNN------
-SS------WWNNNWW----
-WW-----------------
------------------OO
--------------------
-----SS-------------
-----WW-------------
--------------------
--------------------
--------------------
--------------------
---------P----------
-------WWWWW--------
--------------------