--------------------
---SS----------G----
---WW--------NNNN---
--------------------
--------WW----------
-------------SS-----
-------------WW-----
--------------------
--------------------
--------------------
----------SS--------
----------WW--------
--P-----------------
-WWWW-----------OO--
--WW----------------
--------------------