--------------------
--G-----------------
NNNNWWNNNN--WW------
--------------------
-----------------OO-
--------------------
--------------SS----
--------WWF--FNN----
SSS-----------NN----
NNN-----F-----N-----
NNN-----------------
NNNNN---------------
-NNN----------------
-------------P------
-----------WWWW-----
--------------------