--------S-S--S------
---S-S--W-N--W------
---W-N----N------NO-
----------------NN--
----------B----NNN--
-----N----N---------
--------------------
-------S---------S--
-------W---F-A--FN--
-OOO----------------
--------------------
--------------------
--------------------
--SSSSSSSS------P---
--NNNNNNNN---NNNNN--
L-------------------