--------------------
--------SS----------
--------NNNNNNNNN---
-SS------WWNANWW----
-WW-----------------
------------------OO
--------------------
-----SS-------------
-----WW-------------
--------------------
--------------------
--------------------
--------------------
---------P----------
-------WWWWW--------
--------------------