--------------------
---------------G----
--------WW---NNNN---
--------------------
---OO---------------
-------------SS-----
-------------WW-----
--------------------
--------------------
--------------------
----------SS--------
----------WW--------
--P-----------------
-WWWW-----------OO--
--WW----------------
--------------------