--SSSSSSSSSSSSS-----
--NNNNNNNNNNNNW-----
-------WW---N---OO--
------------N-------
------------N---BB--
----------S-N---NN--
--SS------N-N-------
--WW---F--N-N-------
----------N-W-------
----------N---------
----------N-----NW--
----------N---------
----------N---------
--------P-N-------A-
------NNNNN---------
--------------------