--------------------
-------------WW-----
--------------------
-----------------OO-
--------------------
--------------------
--------SSSSSSSS----
-ONOO---WWNNNNNN--A-
--N----F-------N----
--N--BB--------N----
--N--NN-------------
--------------------
--------------------
-----------P--------
-----------WWWWW----
R-------------------