--------------------
--------------------
--------------------
--------------------
--------------------
------------G-------
----W-WW-WW-WW-WW-W- 
----WWWWWWWWWWWWWWW-
----WWWWWWWWWWWWWWW-
---OWWWWWWWWWWWWWWW-
----WWWWWWWWWWWWWWW-
----WWWWWWWWWWWWWWW-
----WWWWWWWWWWWWWWW-
---PWWWWWWWWWWWWWWW-
--OOWWWWWWWWWWWWWWW-
--------------------