--------------------
--------------------
-----------NNNN-----
------R-------------
----NNNNN-----------
-----NNN---R--------
-----------NNNNN----
------------NNN-----
-----------------OO-
--------------------
------------------R-
---------R----WWWWW-
--P----WWWWW---WWW--
-WWWW---WWW-----A---
--WW----------------
--------------------