--------------------
-------------WW-----
--------------------
-----------------OO-
--------------------
--------------------
--------SSSSSSSS----
-ONOO---WWNNNNNN----
--N----F-------N----
--N--BB--------N----
--N--NN-------------
--------------------
--------------------
-----------P---S----
-----------WWWWW----
R-------------------