--------------------
SSSSSSSSSS----------
NNNNWWNNNN--WW------
--------------------
-----------------OO-
--------------------
--------------SS----
--------WWF--FNN--A-
SSS-----------NW----
NNN-----F-----N-----
NNN-----------------
NNNNN---------------
-NNN----------------
-------------P------
-----------WWWW-----
--------------------