------------WOOOWWWW
----------------WWWW
----------------WWWW
---------------WWWWW
----------------NWWW
----------------NWWW
----------------NWWW
----------------NWWW
----------------NWWW
----WWWWWWWWWWWWWWWW
----WWWWWWWWWWWWWWWW
---OWWWWWWWWWWWWWWWW
-----WWWWWWWWWWWWWWW
---P-WWWWWWWWWWWWWWW
--OOOWWWWWWWWWWWWWWW
--------------------