--------------------
-------SS-----------
--S----WW-----NN----
--N-----------NN----
--N--F-------ONN--A-
--N--------SS-NN----
-----------WW-NN----
--------------------
------BBB-----------
------NNN-----------
--------------------
--------------------
------------BBB-----
-------P----WWW-----
------WWW-----------
--------------------