--NNNNNWWNNWWN------
--------------------
---------------OOO--
-----S--S--S--S-----
-R---NF-NF-NF-N-----
-OOOON--------------
-----N----------SS--
-A--RN--WWNNN---WW--
-OOOON------N-------
-----N------NO------
-R---N-----SN-------
-OOOONSS---NN-------
-----WWW----N-------
------------N-P-----
-OOOO-------NNNNN---
R-------------------