00000000000000000000
00000000000000000000
00000000000000000000
00000000000000000000
00000000000000000000
00200000000000000000
03444433333300334430
03000000000000000030
03000000000000000030
03003000300000000030
04440000003303307730
00000010003303307730
00000000006666607730
03333333333333333330
00000000000000000000