--------------------
--------------------
--WWW---------------
-----------WWW------
--------------------
--------------------
----------------OOO-
---WWWWW------------
--------------------
--------------------
---------------WWW--
--------OOOO--------
--P-----------------
WWWWWWWWWWWWWWWWWWWW
--------------------