00000000000000000000
00000000000000000000
00000000000000000000
00000000000000000000
00000000000000000000
00200000000000000000
03444433333300334430
03000000000000000030
03000000000000000030
03000000000000000030
04444400003333300030
00000000000000000030
00100000006666600030
03333333333333333330
00000000000000000000