00000000000000000000
00000000000000000000
00000000000000000000
00000000000000000000
00000000000000000000
00000000000000000000
01222211111100112210
01000000000000000010
01000000000000000010
01000000000000000010
02222200001111100010
00000000000000000010
00300000000000000010
01111111111111111110
00000000000000000000